JPMorgan    JPMorgan    kA
Munich	Munich	kA
Re	Re	kA
Barclays	Barclays	kA
Societe	Societe	kA
Generale	Generale	kA
strong	strong	kA
perform	perform	kA
market	market	kA
Raymond	Raymond	kA
James	James	kA
Atlantic	Atlantic	kA
of	of	kA
Société	Société	kA
Credit	Credit	kA
outperform	outperform	kA
underperform	underperform	kA
Morgan	Morgan	kA
Sanford	Sanford	kA
Stanley	Stanley	kA
equalweight	equalweight	kA
underweight	underweight	kA
Moody´s	Moody´s	kA
Citigroup	Citigroup	kA
Goldman	Goldman	kA
Sachs	Sachs	kA
Lettova	Lettova	kA
Carlyle	Carlyle	kA
Blackstone	Blackstone	kA
Kardan	Kardan	kA
Research	Research	kA
Republic	Republic	kA
Zachodni	Zachodni	kA
Vodafone	Vodafone	kA
Company	Company	kA
Siemens	Siemens	kA
M   M   kA
Zuckerberg  Zuckerberg	kA
Euro	Euro	kA
Group	Group	kA
Mobile	Mobile	kA
Deutsche	Deutsche	kA
Merck	Merck	kA
Telefonica	Telefonica	kA
Sao	Sao	kA
Bravo	Bravo	kA
Markit	Markit	kA
Take-Two	Take-Two	kA
Czech	Czech	kA
Nasdaq	Nasdaq	kA
Seng	Seng	kA
Letty	Letty	kA
Paulo	Paulo	kA
Tauron	Tauron	kA
Nonwovens	Nonwovens	kA
New	New	kA
Stoxx	Stoxx	kA
Beiersdorf	Beiersdorf	kA
T-Mobile	T-Mobile	kA
Amazon	Amazon	kA
Facebook	Facebook	kA
PGNiG	PGNiG	kA
Commerzbank	Commerzbank	kA
Daimler	Daimler	kA
Telefónica	Telefónica	kA
Wyborcza	Wyborcza	kA
Johnson	Johnson	kA
Futures	Futures	kA
Argus	Argus	kA
Kospi	Kospi	kA
Kernel	Kernel	kA
Revolution	Revolution	kA
Clinton	Clinton	kA
Henkel	Henkel	kA
Portugal	Portugal	kA
Nikkei	Nikkei	kA
Groupon	Groupon	kA
Ortho	Ortho	kA
Nike	Nike	kA
Infineon	Infineon	kA
USD/oz	USD/oz	kA
USD/tr	USD/tr	kA
Europe	Europe	kA
J&J	J&J	kA
Composite	Composite	kA
ThyssenKrupp	ThyssenKrupp	kA
Hang	Hang	kA
Monsanta	Monsanta	kA
Wall	Wall	kA
Fedu	Fedu	kA
Eurocash	Eurocash	kA
Erste	Erste	kA
Poland	Poland	kA
Pegas	Pegas	kA
S&P	S&P	kA
Belky	Belky	kA
Tesla	Tesla	kA
Zloty	Zloty	kA
Clinical	Clinical	kA
Gazeta	Gazeta	kA
Fitch	Fitch	kA
Icahna	Icahna	kA
Abe	Abe	kA
Corporation	Corporation	kA
Wood	Wood	kA
Mercedes-Benz	Mercedes-Benz	kA
Hochtief	Hochtief	kA
Nivea	Nivea	kA
Lufthansa	Lufthansa	kA
Santo	Santo	kA
Asseco	Asseco	kA
Bank	Bank	kA
Jones	Jones	kA
Climate	Climate	kA
Netflix	Netflix	kA
Kč	Kč	kA
K+S	K+S	kA
Espirito	Espirito	kA
Orco	Orco	kA
Monsanto	Monsanto	kA
Boers	Boers	kA
Diagnostics	Diagnostics	kA
Mercedes	Mercedes	kA
Dow	Dow	kA
Apple	Apple	kA
Telecom	Telecom	kA
Motors	Motors	kA
BZW	BZW	kA
NFLX	NFLX	kA
EOAN	EOAN	kA
AAPL	AAPL	kA
LTRO	LTRO	kA
MBA	MBA	kA
SIE	SIE	kA
DB1	DB1	kA
AMZN	AMZN	kA
S&P500	S&P500	kA
KGHM	KGHM	kA
TAN	TAN	kA
CETV	CETV	kA
LHA	LHA	kA
TSLA	TSLA	kA
XWZ3	XWZ3	kA
VXX	VXX	kA
MRK	MRK	kA
BAAVIG	BAAVIG	kA
ZSX3	ZSX3	kA
VIG	VIG	kA
ON	ON	kA
DBK	DBK	kA
QGX3	QGX3	kA
BAACETV	BAACETV	kA
ASEANU	ASEANU	kA
ECB	ECB	kA
JNJ	JNJ	kA
VIX	VIX	kA
HEN3	HEN3	kA
BEI	BEI	kA
CME	CME	kA
IFX	IFX	kA
SPZ3	SPZ3	kA
ZWZ3	ZWZ3	kA
SDF	SDF	kA
NWR	NWR	kA
TKA	TKA	kA
SIZ3	SIZ3	kA
PX	PX	kA
BMW	BMW	kA
HGX3	HGX3	kA
ZDZ3	ZDZ3	kA
GCZ3	GCZ3	kA
C	C	kA
XBX3	XBX3	kA
K	K	kA
NFP	NFP	kA
ESZ3	ESZ3	kA
NYSE	NYSE	kA
RWE	RWE	kA
CBK	CBK	kA
US	US	kA
KKR	KKR	kA
CZK	CZK	kA
MON	MON	kA
BAAPEGAS	BAAPEGAS	kA
ZCZ3	ZCZ3	kA
GLA	GLA	kA
FB	FB	kA
ACP	ACP	kA
ISM	ISM	kA
J&J	J&J	kA
XCZ3	XCZ3	kA
&	&	kA
ASX	ASX	kA
JSW	JSW	kA
TASCIANE	TASCIANE	kA
3Q	3Q	kA
NV	NV	kA
GTC	GTC	kA
ADP	ADP	kA
S&P	S&P	kA
LTE	LTE	kA
EUR	EUR	kA
WIG	WIG	kA
KB	KB	kA
WIG20	WIG20	kA
HSBC	HSBC	kA
PMI	PMI	kA
NQZ3	NQZ3	kA
BRE	BRE	kA
KER	KER	kA
USD	USD	kA
TPE	TPE	kA
EIA	EIA	kA
DJIA	DJIA	kA
CAC	CAC	kA
PGE	PGE	kA
PPF	PPF	kA
PGN	PGN	kA
FAS	FAS	kA
NGX3	NGX3	kA
DAI	DAI	kA
BAACEZ	BAACEZ	kA
DAX	DAX	kA
QOZ3	QOZ3	kA
E	E	kA
GRPN	GRPN	kA
NDZ3	NDZ3	kA
K+S	K+S	kA
QMX3	QMX3	kA
HOT	HOT	kA
U	U	kA
DAX30	DAX30	kA
NKE	NKE	kA
TO2	TO2	kA
CLX3	CLX3	kA
KGH	KGH	kA
b  b  kA
mil mil kA
tis tis kA
Empire  Empire  kA
neutral neutral kA
Nomura	Nomura	kA
